###################
#--------#--------#
#@##-###-#-###-##@#
#-----------------#
#-##-#-#####-#-##-#
#----#---#---#----#
####-###-#-###-####
   #-#-------#-#   
####-#-##B##-#-####
 ------#YPI#------ 
####-#-#####-#-####
   #-#-------#-#   
####-#-#####-#-####
#--------#--------#
#-##-###-#-###-##-#
#@-#-----C-----#-@#
##-#-#-#####-#-#-##
#----#---#---#----#
#-######-#-######-#
#-----------------#
###################